NO ./assets/walls/wall_north.xpm
WE ./assets/walls/wall_west.xpm
SO ./assets/walls/wall_south.xpm
EA ./assets/walls/wall_east.xpm

F 202,164,114
C 135,206,235

1111111111111111111111111
1000000000110000000000001
1011000001110000000N00001
1001000000000000000000001
1001000000000000000000001
1001000000000111000000001
1001000000000000000000001
1001000000000000000000001
1111111110110000011101111
1111111111111111111111111
